1
1111111111111111
1210000000100011
1010101110101111
1000100010100011
1111111010101011
1000000010101011
1011111110111011
1010000010001011
1010101111101011
1010100010001011
1010111010111011
1010001000100011
1011101111101011
1000100000001311
1111111111111111
1111111111111111
2
1111111111111111
1200000010000011
1011111011111011
1000001010000011
1110101010111011
1010101010100011
1011111010111111
1000001010000011
1011101011111011
1010101010000011
1010101010111111
1010100000130011
1010111111111011
1000000000000011
1111111111111111
1111111111111111